###########
#..------@#
#..#-$-$--#
#$-#-##---#
#-----$---#
##-----####
###########