--####---
###--####
#-----$-#
#-#--#$-#
#-.-.#@-#
#########
