#####-------
#$$$#######-
#$$$------#-
#$$-####--#-
#$$#####-##-
##-------#--
-#--#--#-###
-#---@-#---#
-##----#---#
--##-###---#
--#--------#
--#####----#
------######
